10
-.-.S.B.P.B.B.P.B.-
G.S.W.S.B.-.-.B.-.-
-.-.S.-.-.-.-.B.-.-
-.B.-.-.S.-.B.P.B.-
B.P.B.S.W.S.-.B.-.S
-.B.-.-.S.-.-.-.S.W
-.-.-.-.B.-.-.-.B.S
-.-.-.B.P.B.-.GB.P.B
-.-.-.-.B.-.-.B.P.B
A.-.-.-.-.-.-.-.B.-