10
-.-.-.-.-.-.-.-.-.-
G.-.-.-.-.-.-.G.-.-
-.-.-.-.-.-.-.-.-.-
-.-.-.-.-.-.-.-.-.-
-.-.-.-.-.-.-.-.-.-
-.-.-.S.-.-.-.-.-.-
-.-.S.W.S.-.-.-.-.-
-.S.-.S.-.-.-.G.-.-
S.W.S.-.-.-.-.-.-.-
A.S.-.-.-.-.-.-.-.-
