10
G.G.-.-.-.-.-.-.-.-
G.G.S.-.-.-.-.-.G.-
-.S.W.S.-.-.-.-.-.S
-.-.S.-.-.-.-.-.S.W
-.-.-.-.S.-.-.-.-.S
-.-.-.S.W.S.-.-.-.-
-.-.-.-.S.-.-.-.-.-
-.-.-.-.-.-.-.G.-.-
-.-.-.-.-.-.-.S.-.-
A.-.-.-.-.-.S.W.S.-

